   **************************************************
*                                                   *
*                            ^                      *
*     ****        ^                        ****     *
*        *                      ^          *        *
*        *                                 *        *
*        *                             $&$ *        *
*        *        *****************        *        *
*        *        *               *        *        *
*        *        |      $$$      *        *  ^     *
*        *        |      $$$      *        *        *
*        *        |      $$$    & *        *        *
*        *        *              #*        *        *
*        *        *****************        *      ^ *
*    ^   *                                 *        *
*        *    ^                            *        *
*        *    &^   ^                       *        *
*     ****                        ^        ****     *
*   ^                                               *
*                                     ^             *
*****************************************************
