   **************************************************
*                                                   *
*                            ^                      *
*     ****        ^                        ****     *
*        *                      ^          *        *
*        *    %                       &    *        *
*        *                                 *        *
*        *        *****************        *        *
*        *        *               *        *        *
*        *        |      $$$      *        *  ^     *
*        *        |      $$$      *        *        *
*        *        |      $$$   &  *        *        *
*        *        *              #*        *        *
*        *        *****************        *      ^ *
*    ^   *                                 *        *
*        *                            %    *        *
*        *   &     ^                       *        *
*     ****                        ^        ****     *
*   ^                                               *
*                                     ^             *
*****************************************************
